
== රංගනය ==
මාලිනී ෆොන්සේකා - වීණා
විජය කුමාරණතුංග - විජිත
රෝයි ද සිල්වා - සින්නා
සුමනා අමරසිංහ - රාජිනි
වේහැල්ලේ පියතිලක - නායක ආරච්චිල
දයානන්ද ජයවර්ධන - රාජිනිගේ පියා
දෙනවක හාමිනේ
මර්වින් ජයතුංග
ජයසේකර අපොන්සු
ශිරාණි නුගේරා
සමන්ති ලැනරෝල්
ශ්‍රීමා කොඩිකාර
ඇග්නස් සිරිසේන
දොන් සිරිසේන
බන්දු සමරසිංහ
කිංස්ලි මාන්නප්පෙරුම
රාජු කුමාරසිංහ


== ගීතයන් ==
සමුදුර සතකින් එහා - වික්ටර් රත්නායක – (පද  උපාලි ධනවලවිතාන)
සාස්තරේ සාස්තරේ කාටදෝ - එච්.ආර්. ජෝතිපාල, ඇන්ජලින් ගුණතිලක
මල් තලාවේ රෑ වලාවේ – ලතා වල්පොල
සීත හිම රැල්ලේ - එච්.ආර්. ජෝතිපාල, සුජාතා අත්තනායක
සරාසඳේ සිනා සේලේ - එච්.ආර්. ජෝතිපාල - (පද කුලරත්න ආරියවංශ)
කඳුළැලි නෑනේ අප රැහේ – මිල්ටන් මල්ලවආරච්චි, චන්ද්‍රිකා සිරිවර්ධන – (පද සෝමපාල ලීලානන්ද)


== නිෂ්පාදනය ==
කැමරා සහාය – බන්දුල කුරේ
සහාය අධ්‍යක්ෂණය – රංජිත් සිරිවර්ධන
අංග රචනය - ඩෙරික් ප්‍රනාන්දු
අංග රචනා සහාය - කේ. ඩී. සිරිපාල, නිමල් රාජපක්ෂ
කලා අධ්‍යක්ෂණය – රංජිත් සිරිවර්ධන
ශබ්ද පරිපාලනය - ජෝර්ජ් මනතුංග(සරසවි චිත්‍රාගාරය)
ශබ්ද සහාය – උපාලි අරඹේවත්ත, උපාලි අරම්පොල, ඩී. එච්. ඒ. ජයමාන්න, ඩබ්ලිව්. ඒ. පොඩි මහත්තයා
ඇඳුම් සැකසුම – අමරා දහනායක, ස්මාට් වෙස්ට්රින් ට්‍රේලර්ස්
කොණ්ඩ සැකසුම සහ ආභරණ – ලලිත් ධර්මවර්ධන
රසායනාගාර සහාය – වී. සිවදාසන්, එස්. යෝගරාජා, ආර්. ජයවර්ධන
නාමාවලිය – නන්ද කුමාර දසනායක
නිෂ්පාදන කළමනාකරණය - කුමාරදාස ජයසිංහ සහාය - එම්. පී. ගුණසේකර
නිෂ්පාදන අධිකාරි – ජී. එම්. ජිනදාස, උපාලි ධනවලවිතාන
නිශ්චල ඡයාරූප – ආනන්ද පෙරේරා